NO ./assets/textures/north.png
SO ./assets/textures/south.png
WE ./assets/textures/west.png
EA ./assets/textures/east.png

F 164,169,20
C 153,204,254


1111
10W1
1111